C 	0,224,255

SO	textures/17.png

WE	textures/18.png	

EA	textures/19.png


NO	textures/16.png


F 	255,0,0


 1 1
1N11111111
1000000001
100000D001
1000D00001
1000000001
1000000001
1111111111